WE pathhh
SE ddd

11111111
10000101
11 000101
11000001
11111111
11110001
10000001
11111111
